# Generate by Level generator v1, written by CG
# Github repo: https://github.com/CGQAQ/Sokoban
@ 3 14 10
2 2 2 2 2 2 2 2 2 2 2 2 0 0
2 4 4 1 1 2 1 1 1 1 1 2 2 2
2 4 4 1 1 2 1 3 1 1 3 1 1 2
2 4 4 1 1 2 3 2 2 2 2 1 1 2
2 4 4 1 1 1 1 5 1 2 2 1 1 2
2 4 4 1 1 2 1 2 1 1 3 1 2 2
2 2 2 2 2 2 1 2 2 3 1 3 1 2
0 0 2 1 3 1 1 3 1 3 1 3 1 2
0 0 2 1 1 1 1 2 1 1 1 1 1 2
0 0 2 2 2 2 2 2 2 2 2 2 2 2